A	AH
A(2)	EY
DAMMIT	D AE M IH T
DAMNIT	D AE M N AH T
GIVE	G IH V
I	AY
ME	M IY
MEETING	M IY T IH NG
NEED	N IY D
PLEASE	P L IY Z
SCHEDULE	S K EH JH UH L
SCHEDULE(2)	S K EH JH UW L
SCHEDULED	S K EH JH UH L D
SCHEDULED(2)	S K EH JH UW L D
TO	T UW
TO(2)	T IH
TO(3)	T AH
WANT	W AA N T
WANT(2)	W AO N T
WANTED	W AO N T IH D
YO	Y OW
